たいぞうかいだいにちにょらい	अ	名詞	胎蔵界大日如来の種子（ア、デーヴァナーガリー文字）
だいにちにょらい	अ	名詞	胎蔵界大日如来の種子（ア、デーヴァナーガリー文字）
だいにち	अ	名詞	胎蔵界大日如来の種子（ア、デーヴァナーガリー文字）
ほうとうにょらい	अ	名詞	宝幢如来の種子（ア、デーヴァナーガリー文字）
ほうとう	अ	名詞	宝幢如来の種子（ア、デーヴァナーガリー文字）
にっこうぼさつ	अ	名詞	日光菩薩の種子（ア、デーヴァナーガリー文字）
にっこう	अ	名詞	日光菩薩の種子（ア、デーヴァナーガリー文字）
かいふけおうにょらい	आ	名詞	開敷華王如来の種子（アー、デーヴァナーガリー文字）
かいふけおう	आ	名詞	開敷華王如来の種子（アー、デーヴァナーガリー文字）
たいぞうかいだいにちにょらい	आुँः	名詞	胎蔵界大日如来の種子（アーンク、デーヴァナーガリー文字）
だいにちにょらい	आुँः	名詞	胎蔵界大日如来の種子（アーンク、デーヴァナーガリー文字）
だいにち	आुँः	名詞	胎蔵界大日如来の種子（アーンク、デーヴァナーガリー文字）
ふくうじょうじゅにょらい	अः	名詞	不空成就如来の種子（アク、デーヴァナーガリー文字）
ふくうじょうじゅ	अः	名詞	不空成就如来の種子（アク、デーヴァナーガリー文字）
てんくらいおんにょらい	अः	名詞	天鼓雷音如来の種子（アク、デーヴァナーガリー文字）
てんくらいおん	अः	名詞	天鼓雷音如来の種子（アク、デーヴァナーガリー文字）
むりょうじゅにょらい	अँ	名詞	無量寿如来の種子（アン、デーヴァナーガリー文字）
むりょうじゅ	अँ	名詞	無量寿如来の種子（アン、デーヴァナーガリー文字）
ふげんぼさつ	अँ	名詞	普賢菩薩の種子（アン、デーヴァナーガリー文字）
ふげん	अँ	名詞	普賢菩薩の種子（アン、デーヴァナーガリー文字）
たいぞうかいだいにちにょらい	अुः	名詞	胎蔵界大日如来の種子（アーク、デーヴァナーガリー文字）
だいにちにょらい	अुः	名詞	胎蔵界大日如来の種子（アーク、デーヴァナーガリー文字）
だいにち	अुः	名詞	胎蔵界大日如来の種子（アーク、デーヴァナーガリー文字）
しゃかにょらい	भः	名詞	釈迦如来の種子（バク、デーヴァナーガリー文字）
しゃか	भः	名詞	釈迦如来の種子（バク、デーヴァナーガリー文字）
やくしにょらい	भै	名詞	薬師如来の種子（バイ、デーヴァナーガリー文字）
やくし	भै	名詞	薬師如来の種子（バイ、デーヴァナーガリー文字）
がっこうぼさつ	च	名詞	月光菩薩の種子（シャ、デーヴァナーガリー文字）
がっこう	च	名詞	月光菩薩の種子（シャ、デーヴァナーガリー文字）
じこくてん	धृ	名詞	持国天の種子（ヂリ、デーヴァナーガリー文字）
かんぎてん	गः	名詞	歓喜天の種子（ギャク、デーヴァナーガリー文字）
かんぎてん	गःगः	名詞	歓喜天の種子（ギャクギャク、デーヴァナーガリー文字）
じぞうぼさつ	ह	名詞	地蔵菩薩の種子（カ、デーヴァナーガリー文字）
じぞう	ह	名詞	地蔵菩薩の種子（カ、デーヴァナーガリー文字）
てんかじぞう	ह	名詞	天華地蔵の種子（カ、デーヴァナーガリー文字）
てんか	ह	名詞	天華地蔵の種子（カ、デーヴァナーガリー文字）
ふどうみょうおう	हाँ	名詞	不動明王の種子（カーン、デーヴァナーガリー文字）
ふどう	हाँ	名詞	不動明王の種子（カーン、デーヴァナーガリー文字）
ふどうみょうおう	ह्म्माँ	名詞	不動明王の種子（カンマーン、デーヴァナーガリー文字）
ふどう	ह्म्माँ	名詞	不動明王の種子（カンマーン、デーヴァナーガリー文字）
あみだにょらい	ह्रीः	名詞	阿弥陀如来の種子（キリーク、デーヴァナーガリー文字）
あみだ	ह्रीः	名詞	阿弥陀如来の種子（キリーク、デーヴァナーガリー文字）
だいいとくみょうおう	ह्रीः	名詞	大威徳明王の種子（キリーク、デーヴァナーガリー文字）
だいいとく	ह्रीः	名詞	大威徳明王の種子（キリーク、デーヴァナーガリー文字）
せんじゅかんのん	ह्रीः	名詞	千手観音の種子（キリーク、デーヴァナーガリー文字）
せんじゅ	ह्रीः	名詞	千手観音の種子（キリーク、デーヴァナーガリー文字）
にょいりんかんのん	ह्रीः	名詞	如意輪観音の種子（キリーク、デーヴァナーガリー文字）
にょいりん	ह्रीः	名詞	如意輪観音の種子（キリーク、デーヴァナーガリー文字）
ぐんだりみょうおう	हुं	名詞	軍荼利明王の種子（ウン、デーヴァナーガリー文字）
ぐんだり	हुं	名詞	軍荼利明王の種子（ウン、デーヴァナーガリー文字）
こんごうやしゃみょうおう	हूं	名詞	金剛夜叉明王の種子（ウーン、デーヴァナーガリー文字）
こんごうやしゃ	हूं	名詞	金剛夜叉明王の種子（ウーン、デーヴァナーガリー文字）
ばとうかんのん	हूं	名詞	馬頭観音の種子（ウーン、デーヴァナーガリー文字）
ばとう	हूं	名詞	馬頭観音の種子（ウーン、デーヴァナーガリー文字）
あしゅくにょらい	हूं	名詞	阿閦如来の種子（ウーン、デーヴァナーガリー文字）
あしゅく	हूं	名詞	阿閦如来の種子（ウーン、デーヴァナーガリー文字）
ごうざんぜみょうおう	हूं	名詞	降三世明王の種子（ウーン、デーヴァナーガリー文字）
ごうざんぜ	हूं	名詞	降三世明王の種子（ウーン、デーヴァナーガリー文字）
あいぜんみょうおう	हूं	名詞	愛染明王の種子（ウーン、デーヴァナーガリー文字）
あいぜん	हूं	名詞	愛染明王の種子（ウーン、デーヴァナーガリー文字）
てんげつじぞう	इ	名詞	天月地蔵の種子（イ、デーヴァナーガリー文字）
てんげつ	इ	名詞	天月地蔵の種子（イ、デーヴァナーガリー文字）
じんぷくじぞう	इ	名詞	人福地蔵の種子（イー、デーヴァナーガリー文字）
じんぷく	इ	名詞	人福地蔵の種子（イー、デーヴァナーガリー文字）
こくいじぞう	इ	名詞	黒衣地蔵の種子（イ、デーヴァナーガリー文字）
こくい	इ	名詞	黒衣地蔵の種子（イ、デーヴァナーガリー文字）
きりじぞう	ई	名詞	枳里地蔵の種子（イー、デーヴァナーガリー文字）
きり	ई	名詞	枳里地蔵の種子（イー、デーヴァナーガリー文字）
ふげんぼさつ	क	名詞	普賢菩薩の種子（キャ、デーヴァナーガリー文字）
ふげん	क	名詞	普賢菩薩の種子（キャ、デーヴァナーガリー文字）
にっこうぼさつ	क	名詞	日光菩薩の種子（キャ、デーヴァナーガリー文字）
にっこう	क	名詞	日光菩薩の種子（キャ、デーヴァナーガリー文字）
じゅういちめんかんのん	क	名詞	十一面観音の種子（キャ、デーヴァナーガリー文字）
じゅういちめん	क	名詞	十一面観音の種子（キャ、デーヴァナーガリー文字）
だいこくてん	म	名詞	大黒天の種子（マ、デーヴァナーガリー文字）
だいこく	म	名詞	大黒天の種子（マ、デーヴァナーガリー文字）
もんじゅぼさつ	मँ	名詞	文殊菩薩の種子（マン、デーヴァナーガリー文字）
もんじゅ	मँ	名詞	文殊菩薩の種子（マン、デーヴァナーガリー文字）
ふくうけんさくかんのん	मो	名詞	不空羂索観音の種子（モウ、デーヴァナーガリー文字）
ふくうけんさく	मो	名詞	不空羂索観音の種子（モウ、デーヴァナーガリー文字）
しょいじぞう	रै	名詞	書衣地蔵の種子（ライ、デーヴァナーガリー文字）
しょい	रै	名詞	書衣地蔵の種子（ライ、デーヴァナーガリー文字）
かんぜおんぼさつ	स	名詞	観世音菩薩の種子（サ、デーヴァナーガリー文字）
かんぜおん	स	名詞	観世音菩薩の種子（サ、デーヴァナーガリー文字）
かんのん	स	名詞	観世音菩薩の種子（サ、デーヴァナーガリー文字）
しょうかんのん	स	名詞	聖観音の種子（サ、デーヴァナーガリー文字）
せいしぼさつ	सः	名詞	勢至菩薩の種子（サク、デーヴァナーガリー文字）
せいし	सः	名詞	勢至菩薩の種子（サク、デーヴァナーガリー文字）
きっしょうてん	श्री	名詞	吉祥天の種子（シリー、デーヴァナーガリー文字）
みょうけんぼさつ	सु	名詞	妙見菩薩の種子（ソ、デーヴァナーガリー文字）
みょうけん	सु	名詞	妙見菩薩の種子（ソ、デーヴァナーガリー文字）
べんざいてん	सु	名詞	弁財天の種子（ソ、デーヴァナーガリー文字）
べんてん	सु	名詞	弁財天の種子（ソ、デーヴァナーガリー文字）
ほうしょうにょらい	त्राः	名詞	宝生如来の種子（タラーク、デーヴァナーガリー文字）
ほうしょう	त्राः	名詞	宝生如来の種子（タラーク、デーヴァナーガリー文字）
こんごうかいだいにちにょらい	वाँः	名詞	金剛界大日如来の種子（バーンク、デーヴァナーガリー文字）
だいにちにょらい	वाँः	名詞	金剛界大日如来の種子（バーンク、デーヴァナーガリー文字）
だいにち	वाँः	名詞	金剛界大日如来の種子（バーンク、デーヴァナーガリー文字）
たもんてん	वै	名詞	多聞天の種子（ベイ、デーヴァナーガリー文字）
びしゃもんてん	वै	名詞	多聞天の種子（ベイ、デーヴァナーガリー文字）
びしゃもん	वै	名詞	多聞天の種子（ベイ、デーヴァナーガリー文字）
こんごうかいだいにちにょらい	वँ	名詞	金剛界大日如来の種子（バン、デーヴァナーガリー文字）
だいにちにょらい	वँ	名詞	金剛界大日如来の種子（バン、デーヴァナーガリー文字）
だいにち	वँ	名詞	金剛界大日如来の種子（バン、デーヴァナーガリー文字）
こうもくてん	वि	名詞	広目天の種子（ビ、デーヴァナーガリー文字）
ぞうちょうてん	वि	名詞	増長天の種子（ビ、デーヴァナーガリー文字）
みろくぼさつ	यु	名詞	弥勒菩薩の種子（ユ、デーヴァナーガリー文字）
みろく	यु	名詞	弥勒菩薩の種子（ユ、デーヴァナーガリー文字）
