あ	अ	名詞	胎蔵界大日如来,宝幢如来,日光菩薩の種子（デーヴァナーガリー文字）
あー	आ	名詞	開敷華王如来の種子（デーヴァナーガリー文字）
あーんく	आुँः	名詞	胎蔵界大日如来の種子（デーヴァナーガリー文字）
あく	अः	名詞	不空成就如来,天鼓雷音如来の種子（デーヴァナーガリー文字）
あん	अँ	名詞	無量寿如来,普賢菩薩の種子（デーヴァナーガリー文字）
あーく	अुः	名詞	胎蔵界大日如来の種子（デーヴァナーガリー文字）
ばく	भः	名詞	釈迦如来の種子（デーヴァナーガリー文字）
ばい	भै	名詞	薬師如来の種子（デーヴァナーガリー文字）
しゃ	च	名詞	月光菩薩の種子（デーヴァナーガリー文字）
ぢり	धृ	名詞	持国天の種子（デーヴァナーガリー文字）
ぎゃく	गः	名詞	歓喜天の種子（デーヴァナーガリー文字）
ぎゃくぎゃく	गःगः	名詞	歓喜天の種子（デーヴァナーガリー文字）
か	ह	名詞	地蔵菩薩,天華地蔵の種子（デーヴァナーガリー文字）
かーん	हाँ	名詞	不動明王の種子（デーヴァナーガリー文字）
かんまーん	ह्म्माँ	名詞	不動明王の種子（デーヴァナーガリー文字）
きりーく	ह्रीः	名詞	阿弥陀如来,大威徳明王,千手観音,如意輪観音の種子（デーヴァナーガリー文字）
うん	हुं	名詞	軍荼利明王の種子（デーヴァナーガリー文字）
うーん	हूं	名詞	金剛夜叉明王,馬頭観音の種子（デーヴァナーガリー文字）
うーん	हूं	名詞	阿閦如来,降三世明王,愛染明王の種子（デーヴァナーガリー文字）
い	इ	名詞	天月地蔵の種子（デーヴァナーガリー文字）
いー	इ	名詞	人福地蔵の種子（デーヴァナーガリー文字）
い	इ	名詞	黒衣地蔵の種子（デーヴァナーガリー文字）
いー	ई	名詞	枳里地蔵の種子（デーヴァナーガリー文字）
きゃ	क	名詞	普賢菩薩,日光菩薩,十一面観音の種子（デーヴァナーガリー文字）
ま	म	名詞	大黒天の種子（デーヴァナーガリー文字）
まん	मँ	名詞	文殊菩薩の種子（デーヴァナーガリー文字）
もう	मो	名詞	不空羂索観音の種子（デーヴァナーガリー文字）
らい	रै	名詞	書衣地蔵の種子（デーヴァナーガリー文字）
さ	स	名詞	観世音菩薩,聖観音の種子（デーヴァナーガリー文字）
さく	सः	名詞	勢至菩薩の種子（デーヴァナーガリー文字）
しりー	श्री	名詞	吉祥天の種子（デーヴァナーガリー文字）
そ	सु	名詞	妙見菩薩,弁財天の種子（デーヴァナーガリー文字）
たらーく	त्राः	名詞	宝生如来の種子（デーヴァナーガリー文字）
ばーんく	वाँः	名詞	金剛界大日如来の種子（デーヴァナーガリー文字）
べい	वै	名詞	多聞天の種子（デーヴァナーガリー文字）
ばん	वँ	名詞	金剛界大日如来の種子（デーヴァナーガリー文字）
び	वि	名詞	広目天,増長天の種子（デーヴァナーガリー文字）
ゆ	यु	名詞	弥勒菩薩の種子（デーヴァナーガリー文字）
