あ	𑖀	名詞	胎蔵界大日如来,宝幢如来,日光菩薩の種子（悉曇文字）
あー	𑖁	名詞	開敷華王如来の種子（悉曇文字）
あーんく	𑖁𑖲𑖼𑖾	名詞	胎蔵界大日如来の種子（悉曇文字）
あく	𑖀𑖾	名詞	不空成就如来,天鼓雷音如来の種子（悉曇文字）
あん	𑖀𑖼	名詞	無量寿如来,普賢菩薩の種子（悉曇文字）
あーく	𑖀𑖲𑖾	名詞	胎蔵界大日如来の種子（悉曇文字）
ばく	𑖥𑖾	名詞	釈迦如来の種子（悉曇文字）
ばい	𑖥𑖹	名詞	薬師如来の種子（悉曇文字）
しゃ	𑖓	名詞	月光菩薩の種子（悉曇文字）
ぢり	𑖠𑖴	名詞	持国天の種子（悉曇文字）
ぎゃく	𑖐𑖾	名詞	歓喜天の種子（悉曇文字）
ぎゃくぎゃく	𑖐𑖾𑖐𑖾	名詞	歓喜天の種子（悉曇文字）
か	𑖮	名詞	地蔵菩薩,天華地蔵の種子（悉曇文字）
かーん	𑖮𑖯𑖼	名詞	不動明王の種子（悉曇文字）
かんまーん	𑖮𑖿𑖦𑖿𑖦𑖯𑖼	名詞	不動明王の種子（悉曇文字）
きりーく	𑖮𑖿𑖨𑖱𑖾	名詞	阿弥陀如来,大威徳明王,千手観音,如意輪観音の種子（悉曇文字）
うん	𑖮𑗜𑖽	名詞	軍荼利明王の種子（悉曇文字）
うーん	𑖮𑗝𑖽	名詞	金剛夜叉明王,馬頭観音の種子（悉曇文字）
うーん	𑖮𑖳𑖽	名詞	阿閦如来,降三世明王,愛染明王の種子（悉曇文字）
い	𑗘	名詞	天月地蔵の種子（悉曇文字）
いー	𑗙	名詞	人福地蔵の種子（悉曇文字）
い	𑖂	名詞	黒衣地蔵の種子（悉曇文字）
いー	𑖃	名詞	枳里地蔵の種子（悉曇文字）
きゃ	𑖎	名詞	普賢菩薩,日光菩薩,十一面観音の種子（悉曇文字）
ま	𑖦	名詞	大黒天の種子（悉曇文字）
まん	𑖦𑖼	名詞	文殊菩薩の種子（悉曇文字）
もう	𑖦𑖺	名詞	不空羂索観音の種子（悉曇文字）
らい	𑖨𑖹	名詞	書衣地蔵の種子（悉曇文字）
さ	𑖭	名詞	観世音菩薩,聖観音の種子（悉曇文字）
さく	𑖭𑖾	名詞	勢至菩薩の種子（悉曇文字）
しりー	𑖫𑖿𑖨𑖱	名詞	吉祥天の種子（悉曇文字）
そ	𑖭𑗜	名詞	妙見菩薩,弁財天の種子（悉曇文字）
たらーく	𑖝𑖿𑖨𑖯𑖾	名詞	宝生如来の種子（悉曇文字）
ばーんく	𑖪𑖯𑖼𑖾	名詞	金剛界大日如来の種子（悉曇文字）
べい	𑖪𑖹	名詞	多聞天の種子（悉曇文字）
ばん	𑖪𑖼	名詞	金剛界大日如来の種子（悉曇文字）
び	𑖪𑖰	名詞	広目天,増長天の種子（悉曇文字）
ゆ	𑖧𑖲	名詞	弥勒菩薩の種子（悉曇文字）
