たいぞうかいだいにちにょらい	𑖀	名詞	胎蔵界大日如来の種子（ア、悉曇文字）
だいにちにょらい	𑖀	名詞	胎蔵界大日如来の種子（ア、悉曇文字）
だいにち	𑖀	名詞	胎蔵界大日如来の種子（ア、悉曇文字）
ほうとうにょらい	𑖀	名詞	宝幢如来の種子（ア、悉曇文字）
ほうとう	𑖀	名詞	宝幢如来の種子（ア、悉曇文字）
にっこうぼさつ	𑖀	名詞	日光菩薩の種子（ア、悉曇文字）
にっこう	𑖀	名詞	日光菩薩の種子（ア、悉曇文字）
かいふけおうにょらい	𑖁	名詞	開敷華王如来の種子（アー、悉曇文字）
かいふけおう	𑖁	名詞	開敷華王如来の種子（アー、悉曇文字）
たいぞうかいだいにちにょらい	𑖁𑖲𑖼𑖾	名詞	胎蔵界大日如来の種子（アーンク、悉曇文字）
だいにちにょらい	𑖁𑖲𑖼𑖾	名詞	胎蔵界大日如来の種子（アーンク、悉曇文字）
だいにち	𑖁𑖲𑖼𑖾	名詞	胎蔵界大日如来の種子（アーンク、悉曇文字）
ふくうじょうじゅにょらい	𑖀𑖾	名詞	不空成就如来の種子（アク、悉曇文字）
ふくうじょうじゅ	𑖀𑖾	名詞	不空成就如来の種子（アク、悉曇文字）
てんくらいおんにょらい	𑖀𑖾	名詞	天鼓雷音如来の種子（アク、悉曇文字）
てんくらいおん	𑖀𑖾	名詞	天鼓雷音如来の種子（アク、悉曇文字）
むりょうじゅにょらい	𑖀𑖼	名詞	無量寿如来の種子（アン、悉曇文字）
むりょうじゅ	𑖀𑖼	名詞	無量寿如来の種子（アン、悉曇文字）
ふげんぼさつ	𑖀𑖼	名詞	普賢菩薩の種子（アン、悉曇文字）
ふげん	𑖀𑖼	名詞	普賢菩薩の種子（アン、悉曇文字）
たいぞうかいだいにちにょらい	𑖀𑖲𑖾	名詞	胎蔵界大日如来の種子（アーク、悉曇文字）
だいにちにょらい	𑖀𑖲𑖾	名詞	胎蔵界大日如来の種子（アーク、悉曇文字）
だいにち	𑖀𑖲𑖾	名詞	胎蔵界大日如来の種子（アーク、悉曇文字）
しゃかにょらい	𑖥𑖾	名詞	釈迦如来の種子（バク、悉曇文字）
しゃか	𑖥𑖾	名詞	釈迦如来の種子（バク、悉曇文字）
やくしにょらい	𑖥𑖹	名詞	薬師如来の種子（バイ、悉曇文字）
やくし	𑖥𑖹	名詞	薬師如来の種子（バイ、悉曇文字）
がっこうぼさつ	𑖓	名詞	月光菩薩の種子（シャ、悉曇文字）
がっこう	𑖓	名詞	月光菩薩の種子（シャ、悉曇文字）
じこくてん	𑖠𑖴	名詞	持国天の種子（ヂリ、悉曇文字）
かんぎてん	𑖐𑖾	名詞	歓喜天の種子（ギャク、悉曇文字）
かんぎてん	𑖐𑖾𑖐𑖾	名詞	歓喜天の種子（ギャクギャク、悉曇文字）
じぞうぼさつ	𑖮	名詞	地蔵菩薩の種子（カ、悉曇文字）
じぞう	𑖮	名詞	地蔵菩薩の種子（カ、悉曇文字）
てんかじぞう	𑖮	名詞	天華地蔵の種子（カ、悉曇文字）
てんか	𑖮	名詞	天華地蔵の種子（カ、悉曇文字）
ふどうみょうおう	𑖮𑖯𑖼	名詞	不動明王の種子（カーン、悉曇文字）
ふどう	𑖮𑖯𑖼	名詞	不動明王の種子（カーン、悉曇文字）
ふどうみょうおう	𑖮𑖿𑖦𑖿𑖦𑖯𑖼	名詞	不動明王の種子（カンマーン、悉曇文字）
ふどう	𑖮𑖿𑖦𑖿𑖦𑖯𑖼	名詞	不動明王の種子（カンマーン、悉曇文字）
あみだにょらい	𑖮𑖿𑖨𑖱𑖾	名詞	阿弥陀如来の種子（キリーク、悉曇文字）
あみだ	𑖮𑖿𑖨𑖱𑖾	名詞	阿弥陀如来の種子（キリーク、悉曇文字）
だいいとくみょうおう	𑖮𑖿𑖨𑖱𑖾	名詞	大威徳明王の種子（キリーク、悉曇文字）
だいいとく	𑖮𑖿𑖨𑖱𑖾	名詞	大威徳明王の種子（キリーク、悉曇文字）
せんじゅかんのん	𑖮𑖿𑖨𑖱𑖾	名詞	千手観音の種子（キリーク、悉曇文字）
せんじゅ	𑖮𑖿𑖨𑖱𑖾	名詞	千手観音の種子（キリーク、悉曇文字）
にょいりんかんのん	𑖮𑖿𑖨𑖱𑖾	名詞	如意輪観音の種子（キリーク、悉曇文字）
にょいりん	𑖮𑖿𑖨𑖱𑖾	名詞	如意輪観音の種子（キリーク、悉曇文字）
ぐんだりみょうおう	𑖮𑗜𑖽	名詞	軍荼利明王の種子（ウン、悉曇文字）
ぐんだり	𑖮𑗜𑖽	名詞	軍荼利明王の種子（ウン、悉曇文字）
こんごうやしゃみょうおう	𑖮𑗝𑖽	名詞	金剛夜叉明王の種子（ウーン、悉曇文字）
こんごうやしゃ	𑖮𑗝𑖽	名詞	金剛夜叉明王の種子（ウーン、悉曇文字）
ばとうかんのん	𑖮𑗝𑖽	名詞	馬頭観音の種子（ウーン、悉曇文字）
ばとう	𑖮𑗝𑖽	名詞	馬頭観音の種子（ウーン、悉曇文字）
あしゅくにょらい	𑖮𑖳𑖽	名詞	阿閦如来の種子（ウーン、悉曇文字）
あしゅく	𑖮𑖳𑖽	名詞	阿閦如来の種子（ウーン、悉曇文字）
ごうざんぜみょうおう	𑖮𑖳𑖽	名詞	降三世明王の種子（ウーン、悉曇文字）
ごうざんぜ	𑖮𑖳𑖽	名詞	降三世明王の種子（ウーン、悉曇文字）
あいぜんみょうおう	𑖮𑖳𑖽	名詞	愛染明王の種子（ウーン、悉曇文字）
あいぜん	𑖮𑖳𑖽	名詞	愛染明王の種子（ウーン、悉曇文字）
てんげつじぞう	𑗘	名詞	天月地蔵の種子（イ、悉曇文字）
てんげつ	𑗘	名詞	天月地蔵の種子（イ、悉曇文字）
じんぷくじぞう	𑗙	名詞	人福地蔵の種子（イー、悉曇文字）
じんぷく	𑗙	名詞	人福地蔵の種子（イー、悉曇文字）
こくいじぞう	𑖂	名詞	黒衣地蔵の種子（イ、悉曇文字）
こくい	𑖂	名詞	黒衣地蔵の種子（イ、悉曇文字）
きりじぞう	𑖃	名詞	枳里地蔵の種子（イー、悉曇文字）
きり	𑖃	名詞	枳里地蔵の種子（イー、悉曇文字）
ふげんぼさつ	𑖎	名詞	普賢菩薩の種子（キャ、悉曇文字）
ふげん	𑖎	名詞	普賢菩薩の種子（キャ、悉曇文字）
にっこうぼさつ	𑖎	名詞	日光菩薩の種子（キャ、悉曇文字）
にっこう	𑖎	名詞	日光菩薩の種子（キャ、悉曇文字）
じゅういちめんかんのん	𑖎	名詞	十一面観音の種子（キャ、悉曇文字）
じゅういちめん	𑖎	名詞	十一面観音の種子（キャ、悉曇文字）
だいこくてん	𑖦	名詞	大黒天の種子（マ、悉曇文字）
だいこく	𑖦	名詞	大黒天の種子（マ、悉曇文字）
もんじゅぼさつ	𑖦𑖼	名詞	文殊菩薩の種子（マン、悉曇文字）
もんじゅ	𑖦𑖼	名詞	文殊菩薩の種子（マン、悉曇文字）
ふくうけんさくかんのん	𑖦𑖺	名詞	不空羂索観音の種子（モウ、悉曇文字）
ふくうけんさく	𑖦𑖺	名詞	不空羂索観音の種子（モウ、悉曇文字）
しょいじぞう	𑖨𑖹	名詞	書衣地蔵の種子（ライ、悉曇文字）
しょい	𑖨𑖹	名詞	書衣地蔵の種子（ライ、悉曇文字）
かんぜおんぼさつ	𑖭	名詞	観世音菩薩の種子（サ、悉曇文字）
かんぜおん	𑖭	名詞	観世音菩薩の種子（サ、悉曇文字）
かんのん	𑖭	名詞	観世音菩薩の種子（サ、悉曇文字）
しょうかんのん	𑖭	名詞	聖観音の種子（サ、悉曇文字）
せいしぼさつ	𑖭𑖾	名詞	勢至菩薩の種子（サク、悉曇文字）
せいし	𑖭𑖾	名詞	勢至菩薩の種子（サク、悉曇文字）
きっしょうてん	𑖫𑖿𑖨𑖱	名詞	吉祥天の種子（シリー、悉曇文字）
みょうけんぼさつ	𑖭𑗜	名詞	妙見菩薩の種子（ソ、悉曇文字）
みょうけん	𑖭𑗜	名詞	妙見菩薩の種子（ソ、悉曇文字）
べんざいてん	𑖭𑗜	名詞	弁財天の種子（ソ、悉曇文字）
べんてん	𑖭𑗜	名詞	弁財天の種子（ソ、悉曇文字）
ほうしょうにょらい	𑖝𑖿𑖨𑖯𑖾	名詞	宝生如来の種子（タラーク、悉曇文字）
ほうしょう	𑖝𑖿𑖨𑖯𑖾	名詞	宝生如来の種子（タラーク、悉曇文字）
こんごうかいだいにちにょらい	𑖪𑖯𑖼𑖾	名詞	金剛界大日如来の種子（バーンク、悉曇文字）
だいにちにょらい	𑖪𑖯𑖼𑖾	名詞	金剛界大日如来の種子（バーンク、悉曇文字）
だいにち	𑖪𑖯𑖼𑖾	名詞	金剛界大日如来の種子（バーンク、悉曇文字）
たもんてん	𑖪𑖹	名詞	多聞天の種子（ベイ、悉曇文字）
びしゃもんてん	𑖪𑖹	名詞	多聞天の種子（ベイ、悉曇文字）
びしゃもん	𑖪𑖹	名詞	多聞天の種子（ベイ、悉曇文字）
こんごうかいだいにちにょらい	𑖪𑖼	名詞	金剛界大日如来の種子（バン、悉曇文字）
だいにちにょらい	𑖪𑖼	名詞	金剛界大日如来の種子（バン、悉曇文字）
だいにち	𑖪𑖼	名詞	金剛界大日如来の種子（バン、悉曇文字）
こうもくてん	𑖪𑖰	名詞	広目天の種子（ビ、悉曇文字）
ぞうちょうてん	𑖪𑖰	名詞	増長天の種子（ビ、悉曇文字）
みろくぼさつ	𑖧𑖲	名詞	弥勒菩薩の種子（ユ、悉曇文字）
みろく	𑖧𑖲	名詞	弥勒菩薩の種子（ユ、悉曇文字）
